19
12
22 22 22 22 22 22 22 22 22 22 22 22 22 22 22 22 22 22 22
22 0  0  0  0  0  0  0  0  0  0  0  0  0  0  0  0  22 22
22 0  0  0  0  0  0  0  0  0  0  0  0  0  0  0  0  22 22
22 21 21 21 21 21 21 21 21 21 21 21 21 21 21 25 0  22 22 
22 0  0  0  0  0  0  0  0  0  0  0  0  0  0  0  0  22 22
22 0  0  0  0  0  0  0  0  0  0  0  0  0  0  0  0  22 22
22 0  0  23 21 21 21 21 21 21 21 21 21 21 21 21 21 21 22
22 0  0  0  0  0  0  0  0  0  0  0  0  0  0  0  0  22 22
22 0  0  0  0  0  0  0  0  0  0  0  0  0  0  0  0  22 22
22 21 21 21 21 21 21 21 21 21 21 21 21 21 21 0  21 21 22
22 22 22 22 22 22 22 22 22 22 22 22 22 22 22 0  0  0  22 
22 22 22 22 22 22 22 22 22 22 22 22 22 22 22 21 21 21 21 
