24
24
22 22 22 22 22 22 22 22 22 22 22 22 22 22 22 22 22 22 22 22 22 22 22 22
22 22 22 22 22 22 22 22 22 22 22 22 22 22 22 22 22 22 22 22 22 22 22 22
22 22 0  0  0  0  0  0  0  0  0  0  0  0  0  0  0  0  0  0  0  0  22 22
22 22 0  0  0  0  0  0  0  0  0  0  0  0  0  0  0  0  0  0  0  0  22 22
22 22 0  0  0  0  0  0  0  0  0  0  0  0  0  0  0  0  0  0  0  0  22 22
22 22 0  0  0  0  0  0  0  0  0  0  0  0  0  0  0  0  0  0  0  0  22 22
22 21 21 21 21 21 21 21 21 21 21 21 21 21 21 21 21 21 21 21 0  0  22 22
22 22 22 22 22 22 22 22 22 22 22 22 22 22 22 22 22 22 22 22 0  0  22 22 
22 22 0  0  0  0  0  0  0  0  0  0  0  0  0  0  0  0  0  0  0  0  22 22
22 22 0  0  0  0  0  0  0  0  0  0  0  0  0  0  0  0  0  0  0  0  22 22
22 22 0  0  0  0  0  0  0  0  0  0  0  0  0  0  0  0  0  0  0  0  22 22
22 22 0  0  0  0  0  0  0  0  0  0  0  0  0  0  0  0  0  0  0  0  22 22
22 22 0  0  21 21 21 21 21 21 21 21 21 21 21 21 21 21 21 21 21 21 22 22
22 22 0  0  22 22 22 22 22 22 22 22 22 22 22 22 22 22 22 22 22 22 22 22
22 22 0  0  0  0  0  0  0  0  0  0  0  0  0  0  0  0  0  0  0  0  22 22
22 22 0  0  0  0  0  0  0  0  0  0  0  0  0  0  0  0  0  0  0  0  22 22
22 22 0  0  0  0  0  0  0  0  0  0  0  0  0  0  0  0  0  0  0  0  22 22
22 22 0  0  0  0  0  0  0  0  0  0  0  0  0  0  0  0  0  0  0  0  22 22
22 22 21 21 21 21 21 21 21 21 21 21 21 21 21 21 0  0  21 21 21 21 22 22
22 22 21 21 21 21 21 21 21 21 21 21 21 21 21 21 0  0  21 21 21 21 22 22
22 22 22 22 22 22 22 22 22 22 22 22 22 22 22 22 0  0  0  0  0  0  22 22
22 22 22 22 22 22 22 22 22 22 22 22 22 22 22 22 0  0  0  0  0  0  22 22  
22 22 22 22 22 22 22 22 22 22 22 22 22 22 22 22 22 22 22 22 22 22 22 22
22 22 22 22 22 22 22 22 22 22 22 22 22 22 22 22 22 22 22 22 22 22 22 22
